0 0 0 0 0 0 0 0 0 0 0
31 30 31 30 31 30 31 30 31 30 0
0 31 30 31 30 31 30 31 30 31 0
0 30 31 30 31 30 31 30 31 30 0
0 31 30 31 30 31 30 31 30 31 0
0 30 31 30 31 30 31 30 31 30 0
0 31 30 31 30 31 30 31 30 31 0
0 30 31 30 31 30 31 30 31 30 0
0 31 30 31 30 31 30 31 30 31 0
0 30 31 30 31 30 31 30 31 30 0
0 0 0 0 0 0 0 0 0 0 0